0,0,2,3,1,4,0,2
2,5,4,3,3,3,4,2
0,6,2,4,4,3,3,2
4,4,2,1,0,5,1,1
3,2,1,1,0,0,6,3
3,4,6,2,2,2,0,3
1,1,5,2,2,4,3,3
0,3,1,4,4,1,0,0